ğŸ§± Block Elements (Most Commonly Used First)
These elements stack vertically and are mainly used for layout and structure.

ğŸ”§ Element	ğŸ“„ Description
<div>	ğŸ§° Generic container for flow content
<p>	ğŸ“ Paragraph
<h1>â€“<h6>	ğŸ”  Headings (largest to smallest)
<ul>	ğŸ“‹ Unordered (bulleted) list
<ol>	ğŸ”¢ Ordered (numbered) list
<li>	ğŸ§¾ List item
<form>	ğŸ–Šï¸ Form controls container
<table>	ğŸ“Š Table layout
<section>	ğŸ“š Standalone section
<header>	ğŸšª Page or section intro
<footer>	ğŸ§± Footer of page or section
<nav>	ğŸ§­ Navigation links
<article>	ğŸ“° Self-contained content
<aside>	ğŸ§© Sidebar or additional info
<main>	ğŸ§µ Main content of the document
<fieldset>	ğŸ“¦ Group of form fields
<blockquote>	ğŸ’¬ Quoted block text
<pre>	ğŸ§¾ Preformatted (monospaced) text
<canvas>	ğŸ¨ Drawing graphics with JS
<dl>	ğŸ“˜ Description list
<dt>	ğŸ“Œ Term in the list
<dd>	ğŸ“– Description of the term
<figure>	ğŸ–¼ï¸ Content with caption
<figcaption>	ğŸ·ï¸ Caption for the figure
<address>	ğŸ“¬ Contact information
<hr>	â– Thematic break or horizontal rule
<tfoot>	ğŸ‘£ Footer of a table

ğŸ§· Inline Elements (Most Commonly Used First)
These elements do not break the flow of content â€” they stay in the same line.

ğŸ”§ Element	ğŸ“„ Description
<a>	ğŸ”— Anchor (hyperlink)
<img>	ğŸ–¼ï¸ Image
<span>	ğŸ§µ Generic inline container
<input>	âœï¸ Input field
<label>	ğŸ·ï¸ Label for input field
<strong>	ğŸ’ª Strong importance
<em>	âœ¨ Emphasized text
<br>	â†©ï¸ Line break
<code>	ğŸ’» Code snippet
<b>	ğŸ”¤ Bold (non-semantic)
<i>	ğŸ”  Italic (non-semantic)
<u>	â¬‡ï¸ Underlined text
<small>	ğŸœ Smaller text
<sub>	ğŸ”½ Subscript (e.g., Hâ‚‚O)
<sup>	ğŸ”¼ Superscript (e.g., xÂ²)
<mark>	ğŸ–ï¸ Highlighted/marked text
<q>	â Short quote â
<cite>	ğŸ“š Citation/source
<kbd>	âŒ¨ï¸ Keyboard input
<samp>	ğŸ§ª Sample output
<var>	ğŸ“ Variable (math/code)
<time>	ğŸ•’ Time or date
<abbr>	ğŸ”¤ Abbreviation
<data>	ğŸ“ Machine-readable value
<acronym>	ğŸš« Deprecated in HTML5